##################################
##################################
..................................
..................................
..................................
..................................
##....####................##....##
##....####................##....##
##........................##....##
##........................##....##
##........................##....##
##........................##....##
##........................##....##
##....######################....##
##....######################....##
##....##........................##
##....##........................##
##....##........................##
##....##........................##
##....##........................##
##....##................####....##
##....##................####....##
##..............................##
##..............................##
##..............................##
##..............................##
##################################
##################################